2,2,2,2,2,2,2,2,2,2,2,2
2,2,2,2,2,2,2,2,2,2,2,2
2,2,0,3,3,2,2,2,2,2,2,2
2,3,3,2,3,2,2,2,2,2,2,2
2,3,2,2,3,3,2,2,2,2,2,2
2,3,3,3,8,3,2,2,2,2,2,2
2,3,2,2,3,2,2,2,2,2,2,2
2,8,3,3,3,3,3,3,3,2,2,2
2,3,2,2,2,2,2,3,2,3,2,2
2,3,3,3,3,3,3,3,1,3,2,2
2,2,2,2,2,2,2,2,2,2,2,2
2,2,2,2,2,2,2,2,2,2,2,2