2,2,2,2,2,2,2,2,2,2,2,2,2,2
2,3,3,3,3,3,3,3,3,3,3,3,3,2
2,3,3,0,3,3,3,3,3,3,3,3,3,2
2,3,3,3,3,3,3,3,3,3,2,3,3,2
2,3,3,3,2,3,3,3,3,3,3,3,3,2
2,3,3,3,3,3,3,3,3,3,3,3,3,2
2,3,3,3,2,3,3,4,3,3,3,3,3,2
2,3,3,3,3,3,3,3,3,3,3,3,2,2
2,3,3,3,3,3,3,5,1,2,3,3,3,2
2,3,3,3,3,2,3,3,3,3,3,3,3,2
2,3,3,3,3,3,3,3,3,3,3,2,3,2
2,3,3,2,3,3,3,3,3,3,3,3,3,2
2,3,3,3,3,3,3,3,3,3,3,3,3,2
2,2,2,2,2,2,2,2,2,2,2,2,2,2