2,2,2,2,2,2,2,2,2,2,2,2
2,2,0,6,3,3,2,2,2,2,2,2
2,2,6,2,2,6,2,2,2,2,2,2
2,2,3,2,2,3,2,2,2,2,2,2
2,2,3,3,6,3,2,2,2,2,2,2
2,2,6,2,2,6,2,2,2,2,2,2
2,2,3,2,2,2,2,2,2,2,2,2
2,2,3,6,3,6,3,6,3,3,2,2
2,2,3,3,1,6,6,3,6,3,2,2
2,2,2,2,2,3,2,2,2,2,2,2
2,2,2,2,2,2,2,2,2,2,2,2
2,2,2,2,2,2,2,2,2,2,2,2