2,2,2,2,2,2,2,2,2,2,2,2
2,2,2,2,2,2,2,2,2,2,2,2
2,2,3,0,3,6,3,3,2,2,2,2
2,2,3,6,2,3,2,6,2,2,2,2
2,2,3,3,3,3,3,3,2,2,2,2
2,2,6,6,2,2,3,3,3,3,2,2
2,2,3,3,2,3,3,2,2,6,2,2
2,2,3,3,6,3,6,2,3,3,3,2
2,2,2,2,6,3,3,3,3,2,2,2
2,2,2,2,2,1,2,2,2,2,2,2
2,2,2,2,2,2,2,2,2,2,2,2
2,2,2,2,2,2,2,2,2,2,2,2
