2,2,2,2,2,2,2,2,2,2,2,2
2,2,2,2,2,2,2,2,2,2,2,2
2,2,3,3,3,3,3,2,3,3,2,2
2,2,3,2,3,2,3,2,3,2,1,2
2,2,4,3,0,2,3,3,3,5,3,2
2,3,3,3,2,3,3,2,3,2,2,2
2,2,3,3,3,3,3,3,3,3,2,2
2,2,2,2,3,2,3,2,2,2,2,2
2,2,2,2,4,3,2,2,2,2,2,2
2,2,2,2,2,2,2,2,2,2,2,2
2,2,2,2,2,2,2,2,2,2,2,2
2,2,2,2,2,2,2,2,2,2,2,2
