2,2,2,2,2,2,2,2,2,2,2,2
2,2,2,2,2,2,2,2,2,2,2,2
2,2,2,3,0,3,7,3,2,2,2,2
2,2,2,7,3,3,2,7,2,2,2,2
2,2,2,7,2,3,3,7,2,2,2,2
2,2,2,7,2,3,3,3,3,2,2,2
2,2,2,3,9,3,7,3,3,2,2,2
2,2,2,3,7,3,7,1,3,2,2,2
2,2,2,2,2,2,3,2,2,2,2,2
2,2,2,2,2,2,2,2,2,2,2,2
2,2,2,2,2,2,2,2,2,2,2,2
2,2,2,2,2,2,2,2,2,2,2,2