2,2,2,2,2,2,2,2,2,2,2,2,2,2,2
2,2,2,2,2,2,2,2,2,2,2,2,2,2,2
2,2,2,2,2,2,3,2,2,2,3,2,2,2,2
2,2,2,2,2,2,7,3,2,3,7,7,2,2,2
2,2,2,2,7,3,7,7,3,7,7,3,7,2,2
2,2,2,7,7,7,7,3,7,3,7,7,7,3,3
2,2,3,7,7,7,3,7,3,3,7,7,7,7,3
2,2,7,3,7,7,2,1,7,7,7,7,7,3,2
2,2,3,7,3,7,0,7,7,7,3,7,3,2,2
2,2,3,7,3,7,7,7,9,3,7,7,2,2,2
2,3,7,7,7,3,3,7,7,3,7,3,2,2,2
2,2,2,3,7,7,7,7,2,3,3,7,3,2,2
2,2,2,2,7,7,3,2,2,2,3,7,3,2,2
2,2,2,2,2,2,2,2,2,2,2,3,2,2,2
2,2,2,2,2,2,2,2,2,2,2,2,2,2,2
