2,2,2,2,2,2,2,2,2,2,2,2
2,2,2,2,2,2,3,3,2,2,2,2
2,2,2,2,3,0,3,2,3,2,2,2
2,2,2,3,3,2,2,2,2,3,2,2
2,2,2,2,3,3,8,3,3,3,3,2
2,2,2,3,3,2,2,3,2,3,2,2
2,2,3,2,2,2,3,2,1,3,3,2
2,2,2,3,8,2,3,2,3,2,2,2
2,2,2,2,3,3,3,3,3,2,2,2
2,2,2,2,3,3,3,3,2,2,2,2
2,2,2,2,2,2,2,2,2,2,2,2
2,2,2,2,2,2,2,2,2,2,2,2